1111111111111111111111111111111111111111111111111111111111111111111111111111111111111111111111
10E0000000000000000000000000000000000000000000000000000000000000000000000000000000000000000001
1000000000000000000000000000000000000000000000000000000000000000000000000000000000000000000001
1000000000000000000000000000000000000000000000000000000000000000000000000000000000000000000001
1000000000000000000000000000000000000000000000000000000000000000000000000000000000000000000001
1000000000000000000000000000000000000000000000000000000000000000000000000000000000000000000001
1000000000000000000000000000000000000001111111111100001111111111100011111111111000000000000001
1000000000000000000000000000000000000111111111110000001111111110000011111111111000000000000001
1000000000000000000000000000000000011111111111000000001111111000000011111111111000000000000001
1000000000000000000000000000000001111111111100000000001111100000000011111111111000000000000001
1000000000000000000000000000000111111111110000000000001110000000000011111111111000000000000001
1000000000000000000000000000011111111111000000000000001000000000000011111111111000000000000001
1000000000000000000000000001111111111100000000000000000000000000001111111111100000000000000001
1000000000000000000000000111111111110000000000000000000000000000111111111110000000000000000001
1000000000000000000000011111111111000000000000000000000000000011111111111100000000000000000001
1000000000000000000001111111111100000000000000000000000000001111111111100000000000000000000001
1000000000000000000111111111110000000000000000000000000000111111111110000000000000000000000001
1000000000000000011111111111000000000000000000000000000011111111111000000000000000000000000001
1000000000000001111111111111111111111111111111111100001111111111100000000000001000000000000001
1000000000000001111111111111111111111111111111111100001111111111100000000000111000000000000001
1000000000000001111111111111111111111111111111111100001111111111100000000011111000000000000001
1000000000000001111111111111111111111111111111111100001111111111100000001111111000000000000001
1000000000000000000000000000000000000001111111111100001111111111100000111111111000000000000001
1000000000000000000000000000000000000001111111111100001111111111100011111111111000000000000001
1000000000000000000000000000000000000001111111111100000000000000000000000000000000000000000001
1000000000000000000000000000000000000001111111111100000000000000000000000000000000000000000001
1000000000000000000000000000000000000001111111111100000000000000000000000000000000000000000001
1000000000000000000000000000000000000001111111111100000000000000000000000000000000000000000001
1000000000000000000000000000000000000000000000000000000000000000000000000000000000000000000001
1000000000000000000000000000000000000000000000000000000000000000000000000000000000000000000001
1000000000000000000000000000000000000000000000000000000000000000000000000000000000000000000001
1000000000000000000000000000000000000000000000000000000000000000000000000000000000000000000001
1P00000000000000000000000000000000000000000000000000000000000000000000000000000000000000000001
1111111111111111111111111111111111111111111111111111111111111111111111111111111111111111111111