1111111111111
1C010000000C1
1000011111001
1P0011E000C00
1111111111111