111111
1P0001
1C0C01
100001
1C0E11
111111
