1111111
1P00001
1C0C001
1000001
1C0E001
1111111
