11111111111111
1C010000000C01
100001111100A1
1P0011E000C001
11111111111111