1111111111111
1P0000000C0E1
1110111011101
1C0A000010001
1011111010111
1000000C00001
1A01110111011
1000000000001
1111111111111
