1111111111111111111111111111111111
1E000000A000000C00A00C000000000001
1010010100100000101001000000010101
1010010010101010001001000000010101
1P00000A0C00C00000000000000A0000C1
1111111111111111111111111111111111