11111111111111
1P0000010000E1
10111010111011
1A000C0A000001
11101110101111
1C000000000001
11111111111111
