1111111111111
1P000C0000001
1110111011101
1C000100000E1
1011101110111
1A00000000001
1111111111111
