1111111
1P000C1
1A00001
1C0C0E1
1111111
