111111
1P0C01
1C0A01
1000E1
111111
