111111111111
100010E10001
100010A11001
1P0C00C00001
111111111111