1111111111
1P000000E1
1111011111
1C0000C0A1
1111111011
1C00000001
1111011111
1C0000C001
1011111111
1C00000001
1111011111
1A0C00C0A1
1111111011
1C0000C0A1
1C00000001
1A0C00C0A1
1111111011
1C0000C001
1111111111
