1111111111111111
1P00000000000001
1111101111111001
1C00010000000A01
1000001001111001
1A01111000000C01
1000000000000001
1001111001111101
1001000010000A01
1C01000100000001
1001000010111001
1001000000000C01
1001111111100001
1000000000A00001
1A011111100011C1
10000000C0000001
1111111100111111
1C00000001000001
100111000010A001
1000010000100001
1C000100001C0001
1000001111111001
1000A00000000001
1111110000111111
1C00000001000001
10000000A0000E01
1111111111111111
